1111111111111111111111111111
1P00B0010B0B0100001000000011
100C0B00001010000000000E0001
1100B00000000C00001000000011
1010000000000100001000000101
1100010000001000000C00000011
10C00B0000000000000000000001
1000001000001000000000000001
1111111111111111111111111111